VariantSourceEntity - VariantSourceMongo
Annotation - AnnotationMongo
AnnotationMetaData - AnnotationMetaData
VariantDocument - VariantMongo
SimplifiedAnnotation - SimplifiedAnnotation
SimplifiedVariant - SimplifiedVariant
VariantAt - VariantAtMongo
ConsequenceType - ConsequenceTypeMongo
HgvsMongo - HgvsMongo
Score - ScoreMongo
VariantAnnotation - AnnotationIndexMongo
VariantSourceEntryMongo - VariantSourceEntryMongo
VariantStatsMongo - VariantStatisticsMongo
Xref - XrefMongo
VcfReader - VcfReader
AggregatedVcfReader - AggregatedVcfReader
UnwindingItemReader - UnwindingItemReader
UnwindingItemStreamReader - UnwindingItemStreamReader
AggregatedVcfLineMapper - AggregatedVcfLineMapper
FeatureCoordinates - FeatureCoordinates
VariantSourceEntityMongoWriter - VariantSourceMongoWriter
VariantMongoWriter - VariantMongoWriter
JobExecutionApplicationListener - JobExecutionApplicationListener
VariantAggregatedVcfFactory - VariantAggregatedVcfFactory
VariantVcfFactory - VariantVcfFactory
VariantVcfExacFactory - VariantVcfExacFactory
VariantVcfEVSFactory - VariantVcfEVSFactory

NoJobToExecuteException - NoJobToExecuteException
UnknownJobException - UnknownJobException
NoPreviousJobExecutionException - NoPreviousJobExecutionException